[
  {
    "level": 1,
    "width": 10,
    "height": 10,
    "walls": [
      [1, 1, 1, 1, 1, 1, 1, 1, 1, 1],
      [1, 0, 0, 0, 1, 0, 0, 0, 0, 1],
      [1, 0, 1, 0, 1, 0, 1, 1, 0, 1],
      [1, 0, 1, 0, 0, 0, 1, 0, 0, 1],
      [1, 0, 1, 1, 1, 0, 1, 0, 1, 1],
      [1, 0, 0, 0, 0, 0, 0, 0, 0, 1],
      [1, 1, 1, 0, 1, 1, 1, 1, 0, 1],
      [1, 0, 0, 0, 0, 0, 0, 0, 0, 1],
      [1, 0, 1, 1, 1, 1, 1, 1, 1, 1],
      [1, 1, 1, 1, 1, 1, 1, 1, 1, 1]
    ],
    "start": { "row": 1, "col": 1 },
    "patch": { "row": 7, "col": 8 }
  },
  {
    "level": 2,
    "width": 12,
    "height": 12,
    "walls": [
      [1, 1, 1, 1, 1, 1, 1, 1, 1, 1, 1, 1],
      [1, 0, 0, 0, 1, 0, 0, 0, 0, 0, 0, 1],
      [1, 0, 1, 0, 1, 0, 1, 1, 1, 1, 0, 1],
      [1, 0, 1, 0, 0, 0, 0, 0, 0, 1, 0, 1],
      [1, 0, 1, 1, 1, 1, 1, 1, 0, 1, 0, 1],
      [1, 0, 0, 0, 0, 0, 0, 0, 0, 1, 0, 1],
      [1, 1, 1, 1, 1, 0, 1, 1, 1, 1, 0, 1],
      [1, 0, 0, 0, 0, 0, 0, 0, 0, 0, 0, 1],
      [1, 0, 1, 1, 1, 1, 1, 1, 1, 1, 1, 1],
      [1, 0, 0, 0, 0, 0, 0, 0, 0, 0, 0, 1],
      [1, 1, 1, 1, 1, 1, 1, 1, 1, 1, 0, 1],
      [1, 1, 1, 1, 1, 1, 1, 1, 1, 1, 1, 1]
    ],
    "start": { "row": 1, "col": 1 },
    "patch": { "row": 9, "col": 10 }
  },
  {
    "level": 3,
    "width": 14,
    "height": 14,
    "walls": [
      [1, 1, 1, 1, 1, 1, 1, 1, 1, 1, 1, 1, 1, 1],
      [1, 0, 0, 0, 1, 0, 0, 0, 0, 0, 1, 0, 0, 1],
      [1, 0, 1, 0, 1, 0, 1, 1, 1, 0, 1, 0, 1, 1],
      [1, 0, 1, 0, 0, 0, 0, 0, 1, 0, 0, 0, 0, 1],
      [1, 0, 1, 1, 1, 1, 1, 0, 1, 1, 1, 1, 0, 1],
      [1, 0, 0, 0, 0, 0, 0, 0, 0, 0, 0, 0, 0, 1],
      [1, 1, 1, 1, 1, 0, 1, 1, 1, 1, 1, 1, 0, 1],
      [1, 0, 0, 0, 0, 0, 0, 0, 0, 0, 0, 0, 0, 1],
      [1, 0, 1, 1, 1, 1, 1, 1, 1, 1, 1, 1, 1, 1],
      [1, 0, 0, 0, 0, 0, 0, 0, 0, 0, 0, 0, 0, 1],
      [1, 1, 1, 1, 1, 1, 1, 0, 1, 1, 1, 1, 0, 1],
      [1, 0, 0, 0, 0, 0, 0, 0, 0, 0, 0, 0, 0, 1],
      [1, 0, 1, 1, 1, 1, 1, 1, 1, 1, 1, 1, 1, 1],
      [1, 1, 1, 1, 1, 1, 1, 1, 1, 1, 1, 1, 1, 1]
    ],
    "start": { "row": 1, "col": 1 },
    "patch": { "row": 11, "col": 12 }
  },
  {
    "level": 4,
    "width": 15,
    "height": 15,
    "walls": [
      [1, 1, 1, 1, 1, 1, 1, 1, 1, 1, 1, 1, 1, 1, 1],
      [1, 0, 0, 0, 1, 0, 0, 0, 0, 0, 0, 0, 0, 0, 1],
      [1, 0, 1, 0, 1, 0, 1, 1, 1, 1, 1, 1, 1, 0, 1],
      [1, 0, 1, 0, 0, 0, 0, 0, 0, 0, 0, 0, 1, 0, 1],
      [1, 0, 1, 1, 1, 1, 1, 1, 1, 1, 1, 0, 1, 0, 1],
      [1, 0, 0, 0, 0, 0, 0, 0, 0, 0, 0, 0, 1, 0, 1],
      [1, 1, 1, 1, 1, 0, 1, 1, 1, 1, 1, 1, 1, 0, 1],
      [1, 0, 0, 0, 0, 0, 0, 0, 0, 0, 0, 0, 0, 0, 1],
      [1, 0, 1, 1, 1, 1, 1, 1, 1, 1, 1, 1, 1, 1, 1],
      [1, 0, 0, 0, 0, 0, 0, 0, 0, 0, 0, 0, 0, 0, 1],
      [1, 1, 1, 1, 1, 1, 1, 0, 1, 1, 1, 1, 1, 0, 1],
      [1, 0, 0, 0, 0, 0, 0, 0, 0, 0, 0, 0, 0, 0, 1],
      [1, 0, 1, 1, 1, 1, 1, 1, 1, 1, 1, 1, 1, 1, 1],
      [1, 0, 0, 0, 0, 0, 0, 0, 0, 0, 0, 0, 0, 0, 1],
      [1, 1, 1, 1, 1, 1, 1, 1, 1, 1, 1, 1, 1, 1, 1]
    ],
    "start": { "row": 1, "col": 1 },
    "patch": { "row": 13, "col": 13 }
  },
  {
    "level": 5,
    "width": 16,
    "height": 16,
    "walls": [
      [1, 1, 1, 1, 1, 1, 1, 1, 1, 1, 1, 1, 1, 1, 1, 1],
      [1, 0, 0, 0, 1, 0, 0, 0, 0, 0, 0, 0, 1, 0, 0, 1],
      [1, 0, 1, 0, 1, 0, 1, 1, 1, 1, 1, 0, 1, 0, 1, 1],
      [1, 0, 1, 0, 0, 0, 0, 0, 0, 0, 0, 0, 0, 0, 0, 1],
      [1, 0, 1, 1, 1, 1, 1, 1, 1, 1, 1, 1, 1, 1, 0, 1],
      [1, 0, 0, 0, 0, 0, 0, 0, 0, 0, 0, 0, 0, 0, 0, 1],
      [1, 1, 1, 1, 1, 0, 1, 1, 1, 1, 1, 1, 1, 1, 0, 1],
      [1, 0, 0, 0, 0, 0, 0, 0, 0, 0, 0, 0, 0, 0, 0, 1],
      [1, 0, 1, 1, 1, 1, 1, 1, 1, 1, 1, 1, 1, 1, 1, 1],
      [1, 0, 0, 0, 0, 0, 0, 0, 0, 0, 0, 0, 0, 0, 0, 1],
      [1, 1, 1, 1, 1, 1, 1, 0, 1, 1, 1, 1, 1, 1, 0, 1],
      [1, 0, 0, 0, 0, 0, 0, 0, 0, 0, 0, 0, 0, 0, 0, 1],
      [1, 0, 1, 1, 1, 1, 1, 1, 1, 1, 1, 1, 1, 1, 1, 1],
      [1, 0, 0, 0, 0, 0, 0, 0, 0, 0, 0, 0, 0, 0, 0, 1],
      [1, 1, 1, 1, 1, 1, 1, 1, 1, 1, 1, 1, 1, 1, 0, 1],
      [1, 1, 1, 1, 1, 1, 1, 1, 1, 1, 1, 1, 1, 1, 1, 1]
    ],
    "start": { "row": 1, "col": 1 },
    "patch": { "row": 14, "col": 14 }
  },
  {
    "level": 6,
    "width": 12,
    "height": 12,
    "walls": [
      [1, 1, 1, 1, 1, 1, 1, 1, 1, 1, 1, 1],
      [1, 0, 0, 0, 0, 0, 1, 0, 0, 0, 0, 1],
      [1, 0, 1, 1, 1, 0, 1, 0, 1, 1, 0, 1],
      [1, 0, 0, 0, 1, 0, 0, 0, 1, 0, 0, 1],
      [1, 1, 1, 0, 1, 1, 1, 1, 1, 0, 1, 1],
      [1, 0, 0, 0, 0, 0, 0, 0, 0, 0, 0, 1],
      [1, 0, 1, 1, 1, 1, 1, 1, 1, 1, 0, 1],
      [1, 0, 0, 0, 0, 0, 0, 0, 0, 0, 0, 1],
      [1, 1, 1, 0, 1, 1, 1, 1, 1, 0, 1, 1],
      [1, 0, 0, 0, 1, 0, 0, 0, 1, 0, 0, 1],
      [1, 0, 1, 1, 1, 0, 1, 0, 1, 1, 0, 1],
      [1, 1, 1, 1, 1, 1, 1, 1, 1, 1, 1, 1]
    ],
    "start": { "row": 1, "col": 1 },
    "patch": { "row": 10, "col": 10 }
  },
  {
    "level": 7,
    "width": 13,
    "height": 13,
    "walls": [
      [1, 1, 1, 1, 1, 1, 1, 1, 1, 1, 1, 1, 1],
      [1, 0, 0, 0, 1, 0, 0, 0, 0, 0, 0, 0, 1],
      [1, 0, 1, 0, 1, 0, 1, 1, 1, 1, 1, 0, 1],
      [1, 0, 1, 0, 0, 0, 0, 0, 0, 0, 1, 0, 1],
      [1, 0, 1, 1, 1, 1, 1, 1, 1, 0, 1, 0, 1],
      [1, 0, 0, 0, 0, 0, 0, 0, 0, 0, 0, 0, 1],
      [1, 1, 1, 1, 1, 0, 1, 1, 1, 1, 1, 1, 1],
      [1, 0, 0, 0, 0, 0, 0, 0, 0, 0, 0, 0, 1],
      [1, 0, 1, 1, 1, 1, 1, 1, 1, 1, 1, 1, 1],
      [1, 0, 0, 0, 0, 0, 0, 0, 0, 0, 0, 0, 1],
      [1, 1, 1, 1, 1, 0, 1, 1, 1, 1, 1, 0, 1],
      [1, 0, 0, 0, 0, 0, 0, 0, 0, 0, 0, 0, 1],
      [1, 1, 1, 1, 1, 1, 1, 1, 1, 1, 1, 1, 1]
    ],
    "start": { "row": 1, "col": 1 },
    "patch": { "row": 11, "col": 11 }
  },
  {
    "level": 8,
    "width": 14,
    "height": 14,
    "walls": [
      [1, 1, 1, 1, 1, 1, 1, 1, 1, 1, 1, 1, 1, 1],
      [1, 0, 0, 0, 0, 0, 1, 0, 0, 0, 0, 0, 0, 1],
      [1, 0, 1, 1, 1, 0, 1, 0, 1, 1, 1, 1, 0, 1],
      [1, 0, 0, 0, 1, 0, 0, 0, 0, 0, 0, 1, 0, 1],
      [1, 1, 1, 0, 1, 1, 1, 1, 1, 1, 0, 1, 0, 1],
      [1, 0, 0, 0, 0, 0, 0, 0, 0, 0, 0, 0, 0, 1],
      [1, 0, 1, 1, 1, 1, 1, 1, 1, 1, 1, 1, 1, 1],
      [1, 0, 0, 0, 0, 0, 0, 0, 0, 0, 0, 0, 0, 1],
      [1, 1, 1, 1, 1, 0, 1, 1, 1, 1, 1, 1, 0, 1],
      [1, 0, 0, 0, 0, 0, 0, 0, 0, 0, 0, 0, 0, 1],
      [1, 0, 1, 1, 1, 1, 1, 1, 1, 1, 1, 1, 1, 1],
      [1, 0, 0, 0, 0, 0, 0, 0, 0, 0, 0, 0, 0, 1],
      [1, 1, 1, 1, 1, 1, 1, 1, 1, 1, 1, 1, 0, 1],
      [1, 1, 1, 1, 1, 1, 1, 1, 1, 1, 1, 1, 1, 1]
    ],
    "start": { "row": 1, "col": 1 },
    "patch": { "row": 12, "col": 12 }
  }
]

